bbbbbbbbbbbbbbbbbbbb/
bp________________hb/
bmmmmmmmmmmmmmmmmmmb/
b__________________b/
b__________________b/
b__________________b/
b__________________b/
b__________________b/
b_____________i____b/
bbbbbbbbbbbbbbbbbbbb/