bbbbbbbbbbbbbbbbbbbb/
bh______L_________cb/
bm________________cb/
b___________l__cmm_b/
b______________c___b/
b_____c________c___b/
b_____cmmmmmmmmmmmmb/
b_____c____________b/
b___p_c____p_____i_b/
bbbbbbbbbbbbbbbbbbbb/
